!Microsoft IME Dictionary Tool
!Version:
!Format:WORDLIST

ながと	長門	人名
むつ	陸奥	人名
いせ	伊勢	人名
ひゅうが	日向	人名
ゆきかぜ	雪風	人名
あかぎ	赤城	人名
かが	加賀	人名
そうりゅう	蒼龍	人名
ひりゅう	飛龍	人名
しまかぜ	島風	人名
ふぶき	吹雪	人名
しらゆき	白雪	人名
はつゆき	初雪	人名
みゆき	深雪	人名
むらくも	叢雲	人名
いそなみ	磯波	人名
あやなみ	綾波	人名
しきなみ	敷波	人名
おおい	大井	人名
きたかみ	北上	人名
こんごう	金剛	人名
ひえい	比叡	人名
はるな	榛名	人名
きりしま	霧島	人名
ほうしょう	鳳翔	人名
ふそう	扶桑	人名
やましろ	山城	人名
てんりゅう	天龍	人名
たつた	龍田	人名
りゅうじょう	龍驤	人名
むつき	睦月	人名
きさらぎ	如月	人名
さつき	皐月	人名
ふみづき	文月	人名
ながつき	長月	人名
きくづき	菊月	人名
みかづき	三日月	人名
もちづき	望月	人名
くま	球磨	人名
たま	多摩	人名
きそ	木曾	人名
ながら	長良	人名
いすず	五十鈴	人名
なとり	名取	人名
ゆら	由良	人名
せんだい	川内	人名
じんつう	神通	人名
なか	那珂	人名
ちとせ	千歳	人名
ちよだ	千代田	人名
もがみ	最上	人名
ふるたか	古鷹	人名
かこ	加古	人名
あおば	青葉	人名
みょうこう	妙高	人名
なち	那智	人名
あしがら	足柄	人名
はぐろ	羽黒	人名
たかお	高雄	人名
あたご	愛宕	人名
まや	摩耶	人名
ちょうかい	鳥海	人名
とね	利根	人名
ちくま	筑摩	人名
ひよう	飛鷹	人名
じゅんよう	隼鷹	人名
おぼろ	朧	人名
あけぼの	曙	人名
さざなみ	漣	人名
うしお	潮	人名
あかつき	暁	人名
ひびき	響	人名
いかずち	雷	人名
いなづま	電	人名
はつはる	初春	人名
ねのひ	子日	人名
わかば	若葉	人名
はつしも	初霜	人名
しらつゆ	白露	人名
しぐれ	時雨	人名
むらさめ	村雨	人名
ゆうだち	夕立	人名
さみだれ	五月雨	人名
すずかぜ	涼風	人名
あさしお	朝潮	人名
おおしお	大潮	人名
みちしお	満潮	人名
あらしお	荒潮	人名
あられ	霰	人名
かすみ	霞	人名
かげろう	陽炎	人名
しらぬい	不知火	人名
くろしお	黒潮	人名
しょうほう	祥鳳	人名
しょうかく	翔鶴	人名
ずいかく	瑞鶴	人名
きぬ	鬼怒	人名
あぶくま	阿武隈	人名
ゆうばり	夕張	人名
ずいほう	瑞鳳	人名
みくま	三隈	人名
はつかぜ	初風	人名
まいかぜ	舞風	人名
きぬがさ	衣笠	人名
い１９	伊19	人名
すずや	鈴谷	人名
くまの	熊野	人名
いむや	イムヤ	人名
いむや	伊168	人名
い１６８	伊168	人名
ごーや	ゴーヤ	人名
ごーや	伊58	人名
い５８	伊58	人名
い８	伊8	人名
やまと	大和	人名
あきぐも	秋雲	人名
ゆうぐも	夕雲	人名
まきぐも	巻雲	人名
ながなみ	長波	人名
あがの	阿賀野	人名
のしろ	能代	人名
やはぎ	矢矧	人名
さかわ	酒匂	人名
むさし	武蔵	人名
ヴぇーるぬい	Верный	人名
ヴぇーるぬい	ヴェールヌイ	人名
たいほう	大鳳	人名
かとり	香取	人名
しおい	しおい	人名
しおい	伊401	人名
い４０１	伊401	人名
あきつ	あきつ	人名
あきつまる	あきつ丸	人名
かもい	神威	人名
まるゆ	まるゆ	人名
やよい	弥生	人名
うづき	卯月	人名
いそかぜ	磯風	人名
うらかぜ	浦風	人名
たにかぜ	谷風	人名
はまかぜ	浜風	人名
びすまるく	ビスマルク	姓
びすまるく	Bismarck	姓
れーべれひと	レーベレヒト	名
まーす	マース	姓
れーべ	レーベ	名
ｚ１	レーベレヒト・マース	人名
ｚ１	Z1	人名
まっくす	マックス	名
しゅるつ	シュルツ	姓
ｚ３	マックス・シュルツ	人名
ｚ３	Z3	人名
ぷりんつ	プリンツ	名詞
ぷりんつ	Prinz	名詞
おいげん	オイゲン	名
おいげん	Eugen	名
あまつかぜ	天津風	人名
あかし	明石	人名
おおよど	大淀	人名
たいげい	大鯨	人名
りゅうほう	龍鳳	人名
ときつかぜ	時津風	人名
うんりゅう	雲龍	人名
あまぎ	天城	人名
かつらぎ	葛城	人名
はるさめ	春雨	人名
はやしも	早霜	人名
きよしも	清霜	人名
あさぐも	朝雲	人名
やまぐも	山雲	人名
のわき	野分	人名
あきづき	秋月	人名
てるづき	照月	人名
はつづき	初月	人名
たかなみ	高波	人名
あさしも	朝霜	人名
ぐらーふ	グラーフ	名詞
ぐらーふ	Graf	名詞
つぇっぺりん	ツェッペリン	姓
つぇっぺりん	Zeppelin	姓
ぜっぺりん	ツェッペリン	姓
ぜっぺりん	Zeppelin	姓
さらとが	サラトガ	人名
さらとが	Saratoga	人名
う５１１	U-511	人名
ろ５００	呂500	人名
うぉーすぱいと	ウォースパイト	人名
うぉーすぱいと	Warspite	人名
あいおわ	アイオワ	人名
あいおわ	Iowa	人名
りっとりお	リットリオ	人名
りっとりお	Littorio	人名
いたりあ	イタリア	人名
いたりあ	Italia	人名
ろーま	ローマ	人名
ろーま	Roma	人名
りべっちお	リベッチオ	人名
りべっちお	Libeccio	人名
あくぃら	アクィラ	人名
あくぃら	Aquila	人名
あくいら	アクィラ	人名
あくいら	Aquila	人名
あきつしま	秋津洲	人名
ざら	ザラ	人名
ざら	Zara	人名
ぽーら	ポーラ	人名
ぽーら	Pola	人名
みずほ	瑞穂	人名
おきなみ	沖波	人名
かざぐも	風雲	人名
あらし	嵐	人名
はぎかぜ	萩風	人名
おやしお	親潮	人名
やまかぜ	山風	人名
うみかぜ	海風	人名
かわかぜ	江風	人名
はやすい	速吸	人名
かしま	鹿島	人名
かみかぜ	神風	人名
あさかぜ	朝風	人名
はるかぜ	春風	人名
まつかぜ	松風	人名
はたかぜ	旗風	人名
あまぎり	天霧	人名
さぎり	狭霧	人名
みなづき	水無月	人名
にむ	ニム	人名
にむ	伊26	人名
い２６	伊26	人名
ふじなみ	藤波	人名
うらなみ	浦波	人名
こまんだん	コマンダン	名詞
こまんだん	Commandant	名詞
てすと	テスト	姓
てすと	Teste	姓
りしゅりゅー	リシュリュー	人名
りしゅりゅー	Richelieu	人名
しおん	しおん	人名
しおん	伊400	人名
い４００	伊400	人名
い１３	伊13	人名
い１４	伊14	人名
がんぐーと	ガングート	人名
がんぐーと	Гангут	人名
あーくろいやる	アークロイヤル	人名
しむしゅ	占守	人名
くなしり	国後	人名
かすがまる	春日丸	人名
るいーじ	ルイージ	名
るいーじ	Luigi	名
とれっり	トレッリ	姓
とれっり	Torelli	姓
たいよう	大鷹	人名
すずつき	涼月	人名
えとろふ	択捉	人名
まつわ	松輪	人名
さど	佐渡	人名
つしま	対馬	人名

まみや	間宮	人名
いらこ	伊良湖	人名

じゅうにすず	十二鈴	人名
１２すず	十二鈴	人名
ぜかまし	ぜかまし	人名
いずもまん	いずもマン	人名

ろばーつ	Roberts	姓
さみゅえる	Samuel	名
さみゅえる	Samuel B.Roberts	人名
さみゅえる	サミュエル・Ｂ・ロバーツ	人名
さみゅえるびーろばーつ	Samuel B.Roberts	人名
さみゅえるびーろばーつ	サミュエル・Ｂ・ロバーツ	人名
さむ	Samuel B.Roberts	人名
さむ	サミュエル・Ｂ・ロバーツ	人名

ふかえ	福江	人名

ひぶり	日振	人名
だいとう	大東	人名
じゃーヴぃす	Jervis	人名
じゃーびす	Jervis	人名
はまなみ	浜波	人名
たしゅけんと	Ташкент	人名
がんびあべい	Gambier Bay	人名
がんびあ	Gambier Bay	人名
いんとれぴっど	Intrepid	人名

きしなみ	岸波	人名
ごとらんど	Gotland	人名
しんよう	神鷹	人名
まえすとらーれ	Maestrale	人名
まえすとらーれ	Maestrale	名詞
ねるそん	Nelson	人名

みねぐも	峯雲	人名
はやなみ	早波	人名
じょんすとん	Johnston	人名
にっしん	日進	人名

いしがき	石垣	人名
はちじょう	八丈	人名
ふれっちゃー	Fletcher	人名
がりばるでぃ	Garibaldi	姓
がりばるでぃ	G.Garibaldi	人名
がりばるでぃ	Giuseppe Garibaldi	人名
じゅぜっぺ	Giuseppe	名
じゅぜっぺ	G.Garibaldi	人名
じゅぜっぺ	Giuseppe Garibaldi	人名
ころらど	Colorado	人名

みくら	御蔵	人名
じぇーなす	Janus	人名
あぶるっつぃ	Abruzzi	人名
あぶるっつぃ	L.d.S.D.d.Abruzzi	人名
ぐれかーれ	Grecale	人名

ひらと	平戸	人名
でろいてる	De Ruyter	人名
で・ろいてる	De Ruyter	人名
ぱーす	Perth	人名
あとらんた	Atlanta	人名
ひゅーすとん	Houston	人名
あきしも	秋霜	人名
しんしゅうまる	神州丸	人名

うすぐも	薄雲	人名
ありあけ	有明	人名
じんげい	迅鯨	人名
い４７	伊47	人名
だいよんごうかいぼうかん	第四号海防艦	人名
よつ	第四号海防艦	人名

まつ	松	人名
さうすだこた	South Dakota	人名
さうすだこた	サウスダコタ	人名
ほーねっと	Hornet	人名
ほーねっと	ホーネット	人名
へれな	Helena	人名
へれな	ヘレナ	人名
やしろ	屋代	人名

たけ	竹	人名
たんよう	丹陽	人名
しろっこ	Scirocco	人名
しぇふぃーるど	Sheffield	人名
わしんとん	Washington	人名

もも	桃	人名
のーざんぷとん	Nortahmpton	人名
のーざんぷとん	ノーザンプトン	人名
ほのるる	Honolulu	人名
ほのるる	ホノルル	人名
い２０３	伊203	人名
ふーみぃ	伊203	人名
まきなみ	巻波	人名
すずなみ	涼波	人名
そうや	宗谷	人名

かぶーる	Conte di Cavour	人名
かぶーる	Cavour	人名
かぶーる	カブール	人名
こんて・でぃ・かぶーる	Conte di Cavour	人名
こんて・でぃ・かぶーる	コンテ・ディ・カブール	人名
う゛ぃくとりあす Victorious	人名
う゛ぃくとりあす ヴィクトリアス	人名
ちょうげい	長鯨	人名
だいさんじゅうごうかいぼうかん	第三〇号海防艦	人名
だいさんじゅうごう	第三〇号海防艦	人名
みと	第三〇号海防艦	人名